Id,Label,PageRank,DegreeCentrality,BetweennessCentrality,ClosenessCentrality,Community,InDegree,OutDegree,TotalDegree
3998,3998,0.01584895852691536,0.11503067484662577,0.002151008830209305,0.01376985193359215,2,72,3,75
88,88,0.06291755390913922,0.3450920245398773,0.0,0.03593645380264669,0,225,0,225
197061,197061,0.0006400835169744599,0.004601226993865031,0.0,0.0,0,1,2,3
89805,89805,0.0008961534973490783,0.046012269938650305,0.0003416169555096925,0.0004601226993865031,2,3,27,30
377122,377122,0.0028675805773927133,0.003067484662576687,0.0,0.0,-1,1,1,2
120477,120477,0.0004311397742572041,0.0015337423312883436,0.0,0.0,0,0,1,1
80101,80101,0.0024917903269728306,0.009202453987730062,1.4135874021090724e-05,0.00023596035865974517,3,2,4,6
207711,207711,0.0016397023460630316,0.003067484662576687,0.0,6.668444918644971e-05,3,1,1,2
26158,26158,0.0012378153085448823,0.023006134969325152,0.00041936426262569146,0.0010267200730112052,5,5,10,15
11852,11852,0.0004311397742572041,0.004601226993865031,0.0,0.0,2,0,3,3
62391,62391,0.0004311397742572041,0.003067484662576687,0.0,0.0,3,0,2,2
17527,17527,0.0008597798659692954,0.009202453987730062,0.0,4.2603953646898434e-05,10,2,4,6
81181,81181,0.0009502155785588416,0.012269938650306749,4.711958007030241e-06,4.2603953646898434e-05,10,2,6,8
220058,220058,0.0028675805773927133,0.003067484662576687,0.0,0.0,-1,1,1,2
50219,50219,0.0004311397742572041,0.004601226993865031,0.0,0.0,1,0,3,3
4665,4665,0.0009581436256361499,0.007668711656441718,2.3559790035151207e-06,0.0028127428362365336,1,4,1,5
6940,6940,0.012122243603606015,0.02147239263803681,0.0008057448192021713,0.0021222940263951793,4,11,3,14
32972,32972,0.007189603907362895,0.009202453987730062,8.245926512302922e-05,0.0009761808292069001,4,5,1,6
142160,142160,0.0005594359687390184,0.004601226993865031,0.0,0.00021910604732690623,2,1,2,3
64911,64911,0.0010738420442870497,0.013803680981595092,0.001192125375778651,0.006443546063996676,2,2,7,9
162402,162402,0.0019004654114980262,0.01687116564417178,4.0051643059757055e-05,0.0005112474437627812,9,4,7,11
131327,131327,0.0008630011111204369,0.006134969325153374,0.0,0.00013146362839614373,9,1,3,4
407912,407912,0.0004311397742572041,0.004601226993865031,0.0,0.0,2,0,3,3
13808,13808,0.019084024947360743,0.018404907975460124,0.0,0.004543382997370727,7,11,1,12
181190,181190,0.0004311397742572041,0.0015337423312883436,0.0,0.0,-1,0,1,1
5516,5516,0.0007977003299195306,0.0015337423312883436,0.0,5.112474437627812e-05,-1,1,0,1
360368,360368,0.0028675805773927133,0.003067484662576687,0.0,0.0,-1,1,1,2
266400,266400,0.0004311397742572041,0.0015337423312883436,0.0,0.0,4,0,1,1
19913,19913,0.0019672219536386103,0.013803680981595092,0.0,0.001280753905508823,4,9,0,9
35729,35729,0.0006151205071282077,0.009202453987730062,1.8847832028120966e-05,0.0003485778025655326,2,2,4,6
38819,38819,0.0006253507047471183,0.004601226993865031,9.423916014060483e-06,0.0002788622420524261,6,1,2,3
9021,9021,0.01504044308293109,0.027607361963190184,0.0014371471921442237,0.0022449534929744708,6,13,5,18
53508,53508,0.0004311397742572041,0.018404907975460124,0.0,0.0,2,0,12,12
85795,85795,0.0004311397742572041,0.004601226993865031,0.0,0.0,2,0,3,3
13813,13813,0.005199683308152568,0.049079754601226995,0.0029991612714747487,0.010533544052812054,2,29,3,32
163806,163806,0.0004311397742572041,0.004601226993865031,0.0,0.0,1,0,3,3
677,677,0.010887679650529298,0.07822085889570553,0.0,0.009489062403172833,1,51,0,51
13854,13854,0.001504797994498801,0.004601226993865031,0.0,0.0,1,1,2,3
436078,436078,0.0004311397742572041,0.003067484662576687,0.0,0.0,3,0,2,2
216655,216655,0.0007967869730532624,0.004601226993865031,0.0,0.000165809981760902,3,2,1,3
67382,67382,0.0025943017599430436,0.019938650306748466,0.0017127967355554928,0.003792335490377342,5,5,8,13
215057,215057,0.0004311397742572041,0.004601226993865031,0.0,0.0,3,0,3,3
1276,1276,0.002720190504123747,0.032208588957055216,0.0003180571654745413,0.00203117227657105,3,15,6,21
247514,247514,0.0004311397742572041,0.003067484662576687,0.0,0.0,0,0,2,2
69970,69970,0.0015399623468313828,0.007668711656441718,3.769566405624193e-05,0.00023396069460330667,13,2,3,5
141619,141619,0.001540529299646127,0.009202453987730062,8.717122313005947e-05,0.00020602508927753868,13,2,4,6
75798,75798,0.0004311397742572041,0.009202453987730062,0.0,0.0,2,0,6,6
28951,28951,0.0007736502398144917,0.009202453987730062,0.0003298370604921169,0.005735587552627272,0,3,3,6
1988,1988,0.011360897147467885,0.09202453987730061,0.0,0.007347732297225461,3,60,0,60
27311,27311,0.0004311397742572041,0.006134969325153374,0.0,0.0,1,0,4,4
42180,42180,0.0008323917294290814,0.007668711656441718,2.3559790035151207e-06,0.00015337423312883436,19,2,3,5
42179,42179,0.0009894150241221667,0.003067484662576687,0.0,0.00021910604732690623,19,2,0,2
209640,209640,0.0004311397742572041,0.0015337423312883436,0.0,0.0,0,0,1,1
90442,90442,0.0004311397742572041,0.006134969325153374,0.0,0.0,2,0,4,4
92066,92066,0.0004311397742572041,0.004601226993865031,0.0,0.0,2,0,3,3
221491,221491,0.0004311397742572041,0.010736196319018405,0.0,0.0,2,0,7,7
30478,30478,0.0004311397742572041,0.0015337423312883436,0.0,0.0,2,0,1,1
14957,14957,0.0007977003299195306,0.003067484662576687,3.533968505272681e-05,7.668711656441718e-05,2,1,1,2
3533,3533,0.0005760983631090032,0.013803680981595092,3.769566405624193e-05,0.00025562372188139056,2,2,7,9
11991,11991,0.004871196215613267,0.03067484662576687,0.0012357109873436809,0.003957477345640795,2,15,5,20
92274,92274,0.0017380613070776818,0.018404907975460124,0.00013429080320036187,0.0009615690263517594,2,6,6,12
11118,11118,0.0028675805773927133,0.003067484662576687,0.0,0.00025562372188139056,-1,1,1,2
20683,20683,0.0028675805773927133,0.003067484662576687,0.0,8.072328059412334e-05,-1,1,1,2
142345,142345,0.0028675805773927133,0.003067484662576687,0.0,0.00025562372188139056,-1,1,1,2
133894,133894,0.0028675805773927133,0.003067484662576687,0.0,8.072328059412334e-05,-1,1,1,2
191140,191140,0.0009332450420161706,0.003067484662576687,0.0,0.00030674846625766873,9,2,0,2
164933,164933,0.0006806586060339863,0.009202453987730062,2.3559790035151207e-06,0.00017041581458759374,15,2,4,6
74039,74039,0.0009224438202580916,0.003067484662576687,0.0,0.00020449897750511248,15,2,0,2
372150,372150,0.0028675805773927133,0.003067484662576687,0.0,0.00030674846625766873,-1,1,1,2
275600,275600,0.0028675805773927133,0.003067484662576687,0.0,8.072328059412334e-05,-1,1,1,2
388659,388659,0.0004311397742572041,0.003067484662576687,0.0,0.0,3,0,2,2
56968,56968,0.001390485561236358,0.004601226993865031,0.0,0.003442657866519127,2,2,1,3
9036,9036,0.0004311397742572041,0.003067484662576687,0.0,0.0,6,0,2,2
123517,123517,0.001150521603232538,0.003067484662576687,0.0,0.00017041581458759374,0,1,1,2
111728,111728,0.001409619646241301,0.004601226993865031,2.3559790035151207e-06,8.520790729379687e-05,0,1,2,3
131851,131851,0.0004311397742572041,0.004601226993865031,0.0,0.0,1,0,3,3
553,553,0.001048458525517537,0.004601226993865031,1.1779895017575603e-05,0.00036173168190762825,9,2,1,3
227353,227353,0.0028675805773927133,0.003067484662576687,0.0,0.0,-1,1,1,2
324955,324955,0.000784097471001915,0.006134969325153374,0.0,0.0,23,1,3,4
50250,50250,0.0009422039558918815,0.006134969325153374,8.952720213357458e-05,0.00025562372188139056,6,1,3,4
6765,6765,0.0004467249002157762,0.004601226993865031,0.0,0.00035394053798961777,7,1,2,3
76165,76165,0.0008148312735350682,0.012269938650306749,0.00012015492917927115,0.0005521472392638037,2,3,5,8
98204,98204,0.0017644114378246136,0.019938650306748466,0.0013028563889438617,0.003165901419539916,11,7,6,13
26153,26153,0.001473891089139229,0.013803680981595092,8.952720213357458e-05,0.0020248390224932257,11,7,2,9
158955,158955,0.0004311397742572041,0.009202453987730062,0.0,0.0,3,0,6,6
177652,177652,0.0004311397742572041,0.003067484662576687,0.0,0.0,0,0,2,2
182906,182906,0.0007300585785848517,0.010736196319018405,2.5915769038666328e-05,0.00025562372188139056,0,2,5,7
49179,49179,0.0006464967070984929,0.004601226993865031,0.0,9.022013713460845e-05,0,1,2,3
230370,230370,0.0004311397742572041,0.004601226993865031,0.0,0.0,4,0,3,3
29252,29252,0.0004311397742572041,0.004601226993865031,0.0,0.0,0,0,3,3
68285,68285,0.001332057026423719,0.009202453987730062,4.0051643059757055e-05,0.0004182933630786392,3,3,3,6
77058,77058,0.0004311397742572041,0.003067484662576687,0.0,0.0,0,0,2,2
5859,5859,0.005167123794453389,0.007668711656441718,0.0,0.00040599061710573805,10,4,1,5
9704,9704,0.0011089194377952034,0.006134969325153374,0.0,0.0031186094069529653,2,4,0,4
98430,98430,0.0015613457437556144,0.007668711656441718,7.067937010545362e-06,0.0005577244841048522,0,2,3,5
98433,98433,0.0010581771446240248,0.004601226993865031,0.0,0.00015730690577316344,0,1,2,3
130816,130816,0.0026090535494095535,0.007668711656441718,7.067937010545362e-06,0.00043821209465381246,1,2,3,5
130814,130814,0.0017973216380742093,0.004601226993865031,0.0,0.000165809981760902,1,1,2,3
140402,140402,0.0004311397742572041,0.0015337423312883436,0.0,0.0,-1,0,1,1
216,216,0.001497884282568634,0.004601226993865031,0.0,0.0004452800316643578,-1,3,0,3
14615,14615,0.0012354027737626117,0.013803680981595092,2.8271748042181448e-05,0.001154817755322988,4,6,3,9
14588,14588,0.002146384784579338,0.007668711656441718,0.0,0.0009959365787586645,4,5,0,5
149327,149327,0.0004311397742572041,0.0015337423312883436,0.0,0.0,0,0,1,1
202696,202696,0.0006540359481220986,0.003067484662576687,0.0,0.00020299530855286902,9,1,1,2
167376,167376,0.0006456603606585813,0.009202453987730062,7.067937010545362e-06,0.00019171779141104295,1,1,5,6
139524,139524,0.0006307641973030562,0.006134969325153374,2.3559790035151207e-06,9.585889570552147e-05,1,1,3,4
190358,190358,0.0004311397742572041,0.003067484662576687,0.0,0.0,1,0,2,2
314122,314122,0.0020767289162964995,0.003067484662576687,0.0,0.00017041581458759374,-1,1,1,2
372414,372414,0.0036584322384889266,0.006134969325153374,0.0,9.585889570552147e-05,-1,2,2,4
331789,331789,0.0004311397742572041,0.003067484662576687,0.0,0.0,1,0,2,2
57324,57324,0.0028675805773927133,0.003067484662576687,0.0,0.00025562372188139056,-1,1,1,2
57319,57319,0.0028675805773927133,0.003067484662576687,0.0,9.585889570552147e-05,-1,1,1,2
71311,71311,0.0004311397742572041,0.004601226993865031,0.0,0.0,0,0,3,3
8855,8855,0.0027930300432056298,0.003067484662576687,0.0,0.0017416531791167947,6,1,1,2
39885,39885,0.002820382649092436,0.015337423312883436,0.00044763601066787295,0.008998204095459424,2,7,3,10
10179,10179,0.0004311397742572041,0.0015337423312883436,0.0,0.0,0,0,1,1
103447,103447,0.003774454688981094,0.01687116564417178,0.001521962436270768,0.008703152046776581,2,6,5,11
105143,105143,0.0004311397742572041,0.003067484662576687,0.0,0.0,6,0,2,2
15439,15439,0.0004311397742572041,0.006134969325153374,0.0,0.0,2,0,4,4
206362,206362,0.0004311397742572041,0.006134969325153374,0.0,0.0,11,0,4,4
236994,236994,0.0004311397742572041,0.003067484662576687,0.0,0.0,0,0,2,2
257094,257094,0.0004311397742572041,0.003067484662576687,0.0,0.0,0,0,2,2
29937,29937,0.0004311397742572041,0.003067484662576687,0.0,0.0,2,0,2,2
32243,32243,0.0028675805773927133,0.003067484662576687,0.0,0.0,-1,1,1,2
7569,7569,0.0008524145560632456,0.006134969325153374,0.0,0.00025562372188139056,-1,2,2,4
58574,58574,0.0011011928854077712,0.003067484662576687,0.0,0.0002788622420524261,-1,2,0,2
93500,93500,0.0007213321517441016,0.004601226993865031,0.0,0.00015337423312883436,-1,1,2,3
271558,271558,0.0007849800799522863,0.004601226993865031,0.0,0.00010224948875255624,-1,1,2,3
93502,93502,0.0014016061687804238,0.007668711656441718,1.1779895017575603e-05,0.0007668711656441718,12,3,2,5
105601,105601,0.0013768082735248286,0.003067484662576687,0.0,0.0004979682893793322,12,2,0,2
27483,27483,0.0009919026213515575,0.003067484662576687,0.0,0.0010240119422548289,3,2,0,2
135369,135369,0.0004311397742572041,0.004601226993865031,0.0,0.0,1,0,3,3
150857,150857,0.0004311397742572041,0.003067484662576687,0.0,0.0,0,0,2,2
168893,168893,0.0028675805773927133,0.003067484662576687,0.0,0.00030674846625766873,-1,1,1,2
107766,107766,0.0028675805773927133,0.003067484662576687,0.0,0.00010955302366345311,-1,1,1,2
20533,20533,0.0028675805773927133,0.003067484662576687,0.0,0.00021910604732690623,-1,1,1,2
251241,251241,0.0028675805773927133,0.003067484662576687,0.0,0.00010955302366345311,-1,1,1,2
218218,218218,0.0028675805773927133,0.003067484662576687,0.0,0.00025562372188139056,-1,1,1,2
42064,42064,0.0028675805773927133,0.003067484662576687,0.0,0.00010955302366345311,-1,1,1,2
229447,229447,0.0004311397742572041,0.004601226993865031,0.0,0.0,3,0,3,3
238310,238310,0.0010196426243397848,0.004601226993865031,0.0,0.00010955302366345311,0,1,2,3
238311,238311,0.0010380874037878216,0.004601226993865031,0.0,0.00010955302366345311,0,1,2,3
2564,2564,0.0004311397742572041,0.004601226993865031,0.0,0.0,1,0,3,3
27705,27705,0.0013101188639719505,0.009202453987730062,0.0001814103832706643,0.0002788622420524261,4,2,4,6
8835,8835,0.0008643954011590311,0.003067484662576687,0.0,0.00017041581458759374,4,1,1,2
302797,302797,0.0004311397742572041,0.007668711656441718,0.0,0.0,2,0,5,5
318856,318856,0.0028675805773927133,0.003067484662576687,0.0,0.00019171779141104295,-1,1,1,2
406640,406640,0.0028675805773927133,0.003067484662576687,0.0,0.00010955302366345311,-1,1,1,2
344696,344696,0.0004311397742572041,0.003067484662576687,0.0,0.0,4,0,2,2
34796,34796,0.0028675805773927133,0.003067484662576687,0.0,0.0,-1,1,1,2
408904,408904,0.0028675805773927133,0.003067484662576687,0.0,0.00015337423312883436,-1,1,1,2
408905,408905,0.0028675805773927133,0.003067484662576687,0.0,0.00010955302366345311,-1,1,1,2
3994,3994,0.001410574558769164,0.009202453987730062,2.3559790035151207e-05,0.0011247443762781185,1,5,1,6
51640,51640,0.0004311397742572041,0.004601226993865031,0.0,0.0,1,0,3,3
54135,54135,0.0028675805773927133,0.003067484662576687,0.0,0.00021910604732690623,-1,1,1,2
92500,92500,0.0028675805773927133,0.003067484662576687,0.0,0.00010955302366345311,-1,1,1,2
7020,7020,0.0004311397742572041,0.003067484662576687,0.0,0.0,3,0,2,2
103986,103986,0.0004311397742572041,0.003067484662576687,0.0,0.0,16,0,2,2
7690,7690,0.005137241206504067,0.006134969325153374,0.0,0.00034083162917518747,16,3,1,4
120063,120063,0.0005194732977788397,0.006134969325153374,0.0,0.0,2,1,3,4
136111,136111,0.0004311397742572041,0.006134969325153374,0.0,0.0,3,0,4,4
152942,152942,0.0004311397742572041,0.003067484662576687,0.0,0.0,1,0,2,2
349,349,0.0031266449021163153,0.027607361963190184,0.0,0.004271727362590808,1,18,0,18
16990,16990,0.0004311397742572041,0.007668711656441718,0.0,0.0,2,0,5,5
216056,216056,0.0005893868875276294,0.004601226993865031,0.0,0.0,0,1,2,3
240790,240790,0.0004311397742572041,0.003067484662576687,0.0,0.0,0,0,2,2
204755,204755,0.0010678727558332312,0.003067484662576687,0.0,0.00025562372188139056,-1,2,0,2
33833,33833,0.002295056245876028,0.010736196319018405,0.00019790223629527015,0.0015683055387539964,6,4,3,7
35376,35376,0.005565298743527695,0.018404907975460124,0.0024384382686381497,0.0027561805260280627,4,6,6,12
36417,36417,0.0006148001737134969,0.007668711656441718,0.0,0.0,7,1,4,5
389,389,0.0005533266261446463,0.003067484662576687,0.0,0.00025562372188139056,0,1,1,2
403954,403954,0.0004311397742572041,0.007668711656441718,0.0,0.0,2,0,5,5
519,519,0.0011980107203394884,0.009202453987730062,0.0,0.003616997252437051,5,6,0,6
41828,41828,0.0004311397742572041,0.003067484662576687,0.0,0.0,0,0,2,2
61287,61287,0.0004311397742572041,0.0015337423312883436,0.0,0.0,0,0,1,1
68132,68132,0.0006997832032178775,0.003067484662576687,0.0,0.00019719544259421562,13,1,1,2
7501,7501,0.0004311397742572041,0.004601226993865031,0.0,0.0,3,0,3,3
76667,76667,0.0011535476440876205,0.003067484662576687,0.0,0.0005112474437627811,7,1,1,2
52908,52908,0.004647846459677963,0.013803680981595092,3.769566405624193e-05,0.000663239927043608,7,4,5,9
81405,81405,0.0004311397742572041,0.013803680981595092,0.0,0.0,1,0,9,9
16801,16801,0.00288346329707769,0.006134969325153374,0.0,0.008230530282474297,2,4,0,4
50218,50218,0.00512296816061324,0.004601226993865031,0.0,0.0014886322627210393,6,2,1,3
100103,100103,0.0004311397742572041,0.0015337423312883436,0.0,0.0,0,0,1,1
118274,118274,0.0004311397742572041,0.0015337423312883436,0.0,0.0,0,0,1,1
121179,121179,0.0028675805773927133,0.003067484662576687,0.0,0.0,-1,1,1,2
127479,127479,0.0004311397742572041,0.006134969325153374,0.0,0.0,0,0,4,4
138461,138461,0.0004311397742572041,0.0015337423312883436,0.0,0.0,4,0,1,1
37502,37502,0.012013203689712804,0.009202453987730062,0.0,0.0007668711656441718,4,5,1,6
166174,166174,0.0004311397742572041,0.0015337423312883436,0.0,0.0,2,0,1,1
168699,168699,0.0004311397742572041,0.003067484662576687,0.0,0.0,3,0,2,2
168820,168820,0.0004311397742572041,0.003067484662576687,0.0,0.0,0,0,2,2
187458,187458,0.0005083025003483718,0.004601226993865031,2.3559790035151207e-06,0.00025562372188139056,15,1,2,3
2014,2014,0.003481547260454706,0.012269938650306749,7.067937010545362e-06,0.001003904071388734,8,6,2,8
20730,20730,0.0004311397742572041,0.003067484662576687,0.0,0.0,0,0,2,2
20971,20971,0.0028675805773927133,0.003067484662576687,0.0,0.00025562372188139056,-1,1,1,2
79100,79100,0.0028675805773927133,0.003067484662576687,0.0,0.00012781186094069528,-1,1,1,2
232850,232850,0.0004311397742572041,0.004601226993865031,0.0,0.0,3,0,3,3
285111,285111,0.0028675805773927133,0.003067484662576687,0.0,0.00025562372188139056,-1,1,1,2
3424,3424,0.0028675805773927133,0.003067484662576687,0.0,0.00012781186094069528,-1,1,1,2
292088,292088,0.0008430693858654023,0.004601226993865031,7.067937010545362e-06,0.00017041581458759374,8,1,2,3
129929,129929,0.0008612537848332688,0.004601226993865031,4.711958007030241e-06,0.00012781186094069528,8,1,2,3
338829,338829,0.001029497670107975,0.003067484662576687,0.0,0.00021910604732690623,1,1,1,2
145851,145851,0.0013066341855662994,0.004601226993865031,2.3559790035151207e-06,0.00012781186094069528,1,1,2,3
373673,373673,0.0028675805773927133,0.003067484662576687,0.0,0.00025562372188139056,-1,1,1,2
373672,373672,0.0028675805773927133,0.003067484662576687,0.0,0.00012781186094069528,-1,1,1,2
377965,377965,0.0028675805773927133,0.003067484662576687,0.0,0.0,-1,1,1,2
41655,41655,0.0005675541844575391,0.004601226993865031,0.0,0.0007513474578376095,2,1,2,3
42172,42172,0.00206695685602156,0.010736196319018405,0.00046883982169950903,0.0030790310289351944,2,4,3,7
428447,428447,0.0004311397742572041,0.003067484662576687,0.0,0.0,0,0,2,2
43725,43725,0.004085800978960469,0.004601226993865031,0.0,0.00030674846625766873,5,2,1,3
46839,46839,0.0004311397742572041,0.0015337423312883436,0.0,0.0,0,0,1,1
50297,50297,0.002012563737478213,0.003067484662576687,0.0,0.00025562372188139056,-1,1,1,2
50285,50285,0.003722597417307214,0.006134969325153374,0.0,0.00012781186094069528,-1,2,2,4
52122,52122,0.004085800978960469,0.004601226993865031,0.0,0.0005112474437627811,-1,2,1,3
6166,6166,0.004085800978960469,0.004601226993865031,0.0,0.0003608805485384338,-1,2,1,3
56426,56426,0.0009069929281183229,0.007668711656441718,8.952720213357458e-05,0.00025562372188139056,4,1,4,5
69127,69127,0.0004311397742572041,0.006134969325153374,0.0,0.0,4,0,4,4
13797,13797,0.0007848654050296414,0.003067484662576687,0.0,0.00015337423312883436,3,1,1,2
84112,84112,0.0004311397742572041,0.003067484662576687,0.0,0.0,12,0,2,2
8915,8915,0.002455617147641569,0.003067484662576687,0.0,0.0017959627943795766,6,1,1,2
110903,110903,0.00091738578947518,0.007668711656441718,5.1831538077332655e-05,0.0006067552079822019,2,3,2,5
104613,104613,0.0004311397742572041,0.004601226993865031,0.0,0.0,8,0,3,3
2941,2941,0.0024823615958145763,0.009202453987730062,0.0,0.0014445712655157656,8,6,0,6
108134,108134,0.0004311397742572041,0.004601226993865031,0.0,0.0,1,0,3,3
124506,124506,0.0004311397742572041,0.004601226993865031,0.0,0.0,3,0,3,3
128768,128768,0.0004311397742572041,0.003067484662576687,0.0,0.0,0,0,2,2
93314,93314,0.0007137129810607329,0.004601226993865031,7.067937010545362e-06,0.00014684767001696907,13,1,2,3
164883,164883,0.0004311397742572041,0.0015337423312883436,0.0,0.0,0,0,1,1
166106,166106,0.0004311397742572041,0.003067484662576687,0.0,0.0,0,0,2,2
12751,12751,0.006850414248062211,0.010736196319018405,0.0,0.0032441083388002564,5,6,1,7
170689,170689,0.0004311397742572041,0.006134969325153374,0.0,0.0,7,0,4,4
18561,18561,0.0012496128531788132,0.006134969325153374,4.711958007030241e-06,0.00015337423312883436,3,1,3,4
30400,30400,0.0009624808888300049,0.003067484662576687,0.0,0.00013943112102621306,3,1,1,2
192260,192260,0.0004311397742572041,0.003067484662576687,0.0,0.0,-1,0,2,2
10093,10093,0.001138120283458405,0.003067484662576687,0.0,0.00032289312237649337,-1,2,0,2
228749,228749,0.0004311397742572041,0.003067484662576687,0.0,0.0,3,0,2,2
22977,22977,0.0004311397742572041,0.003067484662576687,0.0,0.0,5,0,2,2
235473,235473,0.0004311397742572041,0.003067484662576687,0.0,0.0,4,0,2,2
251638,251638,0.002304795967782587,0.003067484662576687,0.0,0.00017041581458759374,-1,1,1,2
138464,138464,0.003430365187002838,0.006134969325153374,0.0,0.00013943112102621306,-1,2,2,4
25258,25258,0.0004311397742572041,0.003067484662576687,0.0,0.0,16,0,2,2
272131,272131,0.0004311397742572041,0.004601226993865031,0.0,0.0,2,0,3,3
28458,28458,0.003054752695185728,0.007668711656441718,1.4135874021090724e-05,0.0005751533742331289,14,2,3,5
30826,30826,0.0015762516833472827,0.003067484662576687,0.0,0.0002654554034922133,14,1,1,2
297144,297144,0.0004311397742572041,0.004601226993865031,0.0,0.0,4,0,3,3
303072,303072,0.0004311397742572041,0.0015337423312883436,0.0,0.0,0,0,1,1
327935,327935,0.0004311397742572041,0.003067484662576687,0.0,0.0,5,0,2,2
36989,36989,0.0004311397742572041,0.003067484662576687,0.0,0.0,0,0,2,2
383668,383668,0.0004311397742572041,0.003067484662576687,0.0,0.0,2,0,2,2
69237,69237,0.0009788536755881187,0.004601226993865031,0.0,0.0006184444884227192,2,3,0,3
42354,42354,0.0028675805773927133,0.003067484662576687,0.0,0.0,-1,1,1,2
46117,46117,0.0028675805773927133,0.003067484662576687,0.0,0.0,-1,1,1,2
50244,50244,0.002455617147641569,0.004601226993865031,8.717122313005947e-05,0.0017940337258571496,6,1,2,3
51071,51071,0.001109798232316892,0.004601226993865031,2.8271748042181448e-05,0.00030674846625766873,2,1,2,3
35731,35731,0.001007837686740821,0.004601226993865031,5.1831538077332655e-05,0.00022722108611679162,2,1,2,3
54222,54222,0.003354868738019815,0.004601226993865031,0.0,0.00030674846625766873,20,2,1,3
85319,85319,0.0028675805773927133,0.003067484662576687,0.0,0.00025562372188139056,-1,1,1,2
92305,92305,0.0028675805773927133,0.003067484662576687,0.0,0.00013943112102621306,-1,1,1,2
9964,9964,0.0062411139971188054,0.006134969325153374,0.0,0.00040899795501022495,17,3,1,4
105315,105315,0.0028675805773927133,0.003067484662576687,0.0,0.00025562372188139056,-1,1,1,2
29100,29100,0.0028675805773927133,0.003067484662576687,0.0,0.00015337423312883436,-1,1,1,2
120719,120719,0.0004311397742572041,0.003067484662576687,0.0,0.0,0,0,2,2
128515,128515,0.0004311397742572041,0.006134969325153374,0.0,0.0,1,0,4,4
137587,137587,0.0004311397742572041,0.004601226993865031,0.0,0.0,1,0,3,3
138860,138860,0.0028675805773927133,0.003067484662576687,0.0,0.0,-1,1,1,2
13912,13912,0.0015413603843139041,0.004601226993865031,2.3559790035151207e-06,0.00021910604732690623,0,1,2,3
135355,135355,0.0013053227960520574,0.003067484662576687,0.0,0.00015337423312883436,0,1,1,2
57105,57105,0.0008933865056086532,0.004601226993865031,0.0,0.0008227359525454028,4,2,1,3
171054,171054,0.0004311397742572041,0.0015337423312883436,0.0,0.0,0,0,1,1
171734,171734,0.0004311397742572041,0.004601226993865031,0.0,0.0,1,0,3,3
174346,174346,0.0028675805773927133,0.003067484662576687,0.0,0.0,-1,1,1,2
176488,176488,0.0004311397742572041,0.003067484662576687,0.0,0.0,1,0,2,2
191347,191347,0.0004311397742572041,0.003067484662576687,0.0,0.0,1,0,2,2
13239,13239,0.000605692419810693,0.003067484662576687,0.0,0.00015337423312883436,-1,1,1,2
195232,195232,0.0028675805773927133,0.003067484662576687,0.0,0.0,-1,1,1,2
208502,208502,0.0028675805773927133,0.003067484662576687,0.0,0.0,-1,1,1,2
2178,2178,0.0004311397742572041,0.003067484662576687,0.0,0.0,0,0,2,2
220100,220100,0.0028675805773927133,0.003067484662576687,0.0,0.00025562372188139056,-1,1,1,2
220099,220099,0.0028675805773927133,0.003067484662576687,0.0,0.00015337423312883436,-1,1,1,2
19604,19604,0.001231950430392896,0.012269938650306749,0.00011426498167048335,0.003565000253511129,2,5,3,8
237343,237343,0.0004311397742572041,0.003067484662576687,0.0,0.0,0,0,2,2
240806,240806,0.0004311397742572041,0.003067484662576687,0.0,0.0,1,0,2,2
241617,241617,0.0004311397742572041,0.004601226993865031,0.0,0.0,11,0,3,3
260304,260304,0.0004311397742572041,0.003067484662576687,0.0,0.0,2,0,2,2
272861,272861,0.0028675805773927133,0.003067484662576687,0.0,0.00030674846625766873,-1,1,1,2
272862,272862,0.0028675805773927133,0.003067484662576687,0.0,0.00015337423312883436,-1,1,1,2
50305,50305,0.0007406080791870806,0.009202453987730062,1.8847832028120966e-05,0.0001804402742692169,4,1,5,6
279373,279373,0.0004311397742572041,0.003067484662576687,0.0,0.0,0,0,2,2
282758,282758,0.0004311397742572041,0.006134969325153374,0.0,0.0,2,0,4,4
44086,44086,0.0012553015969004521,0.009202453987730062,7.067937010545362e-06,0.0003608805485384338,18,3,3,6
285443,285443,0.0004311397742572041,0.004601226993865031,0.0,0.0,1,0,3,3
37532,37532,0.0015386207291409595,0.009202453987730062,4.711958007030241e-06,0.0005751533742331289,4,4,2,6
3027,3027,0.0004311397742572041,0.003067484662576687,0.0,0.0,0,0,2,2
2287,2287,0.0006602401215461582,0.0015337423312883436,0.0,0.00015337423312883436,0,1,0,1
30742,30742,0.0028675805773927133,0.003067484662576687,0.0,0.00015337423312883436,-1,1,1,2
30750,30750,0.0028675805773927133,0.003067484662576687,0.0,0.00015337423312883436,-1,1,1,2
319990,319990,0.0028675805773927133,0.003067484662576687,0.0,0.0,-1,1,1,2
5226,5226,0.0019611398745404615,0.019938650306748466,0.0,0.0030330958210679796,0,13,0,13
37428,37428,0.0004311397742572041,0.003067484662576687,0.0,0.0,1,0,2,2
394034,394034,0.0023400994689492826,0.003067484662576687,0.0,0.0002788622420524261,-1,1,1,2
96067,96067,0.004161162756116086,0.006134969325153374,4.711958007030241e-06,0.0003834355828220859,-1,2,2,4
6373,6373,0.0016873598155122073,0.003067484662576687,0.0,0.00081799591002045,1,2,0,2
40886,40886,0.0004311397742572041,0.004601226993865031,0.0,0.0,1,0,3,3
420228,420228,0.0004311397742572041,0.003067484662576687,0.0,0.0,2,0,2,2
4322,4322,0.0007030557736631168,0.003067484662576687,0.0,0.00040791019449158076,5,1,1,2
20385,20385,0.0010393239865231635,0.009202453987730062,0.00016020657223902822,0.0005991180981595092,5,2,4,6
4336,4336,0.0032489799663410067,0.012269938650306749,9.423916014060483e-05,0.0012831804652857924,5,5,3,8
11692,11692,0.0018624517842810355,0.007668711656441718,0.0004122963256151461,0.0009126846971398946,5,2,3,5
43722,43722,0.0004311397742572041,0.003067484662576687,0.0,0.0,3,0,2,2
54060,54060,0.0004311397742572041,0.003067484662576687,0.0,0.0,19,0,2,2
62906,62906,0.0004311397742572041,0.003067484662576687,0.0,0.0,3,0,2,2
26398,26398,0.0018768243039832652,0.006134969325153374,3.769566405624193e-05,0.0010544478527607362,3,2,2,4
6241,6241,0.0031911562754431003,0.012269938650306749,7.067937010545361e-05,0.0011720106493807152,3,6,2,8
71888,71888,0.000872499999808269,0.004601226993865031,8.952720213357458e-05,0.0002788622420524261,6,1,2,3
78701,78701,0.0004311397742572041,0.004601226993865031,0.0,0.0,7,0,3,3
90578,90578,0.0004311397742572041,0.003067484662576687,0.0,0.0,4,0,2,2
193543,193543,0.0007999852862376869,0.003067484662576687,0.0,0.00023596035865974517,0,1,1,2
9932,9932,0.0004311397742572041,0.0015337423312883436,0.0,0.0,17,0,1,1
89814,89814,0.001794335537762019,0.004601226993865031,0.0,0.007158525061325212,2,3,0,3
133156,133156,0.0028675805773927133,0.003067484662576687,0.0,0.00021910604732690623,-1,1,1,2
76455,76455,0.0028675805773927133,0.003067484662576687,0.0,0.00017041581458759374,-1,1,1,2
137343,137343,0.0004311397742572041,0.003067484662576687,0.0,0.0,-1,0,2,2
48623,48623,0.0006510761076546001,0.003067484662576687,0.0,0.00017041581458759374,-1,1,1,2
140190,140190,0.0004311397742572041,0.003067484662576687,0.0,0.0,0,0,2,2
144100,144100,0.0007525693743429928,0.003067484662576687,0.0,0.00025562372188139056,22,1,1,2
144099,144099,0.0010710461217985508,0.006134969325153374,4.711958007030241e-06,0.00017041581458759374,22,1,3,4
146381,146381,0.0004311397742572041,0.003067484662576687,0.0,0.0,0,0,2,2
155565,155565,0.0028675805773927133,0.003067484662576687,0.0,0.00025562372188139056,-1,1,1,2
221221,221221,0.0028675805773927133,0.003067484662576687,0.0,0.00017041581458759374,-1,1,1,2
157147,157147,0.0008128872127259966,0.003067484662576687,0.0,0.00019171779141104295,1,1,1,2
25931,25931,0.0011223514048362504,0.006134969325153374,4.711958007030241e-06,0.00017041581458759374,1,1,3,4
165693,165693,0.0004311397742572041,0.003067484662576687,0.0,0.0,2,0,2,2
3547,3547,0.0012175424985040718,0.010736196319018405,6.83233911019385e-05,0.0017254601226993863,2,6,1,7
173809,173809,0.0004311397742572041,0.003067484662576687,0.0,0.0,2,0,2,2
17573,17573,0.0004311397742572041,0.0015337423312883436,0.0,0.0,3,0,1,1
192943,192943,0.0028675805773927133,0.003067484662576687,0.0,0.00025562372188139056,-1,1,1,2
112673,112673,0.0028675805773927133,0.003067484662576687,0.0,0.00017041581458759374,-1,1,1,2
224711,224711,0.0004311397742572041,0.003067484662576687,0.0,0.0,5,0,2,2
228125,228125,0.0004311397742572041,0.003067484662576687,0.0,0.0,3,0,2,2
25907,25907,0.0004311397742572041,0.003067484662576687,0.0,0.0,0,0,2,2
7566,7566,0.0015106008452601934,0.004601226993865031,7.067937010545362e-06,0.0004601226993865031,14,2,1,3
292109,292109,0.0004311397742572041,0.003067484662576687,0.0,0.0,21,0,2,2
35216,35216,0.0010176366633169265,0.003067484662576687,0.0,0.0003834355828220859,21,2,0,2
304714,304714,0.0028675805773927133,0.003067484662576687,0.0,0.00030674846625766873,-1,1,1,2
304715,304715,0.0028675805773927133,0.003067484662576687,0.0,0.00017041581458759374,-1,1,1,2
351318,351318,0.0004311397742572041,0.0015337423312883436,0.0,0.0,-1,0,1,1
64280,64280,0.0007977003299195306,0.0015337423312883436,0.0,0.00017041581458759374,-1,1,0,1
400577,400577,0.0004311397742572041,0.003067484662576687,0.0,0.0,3,0,2,2
446415,446415,0.0004311397742572041,0.0015337423312883436,0.0,0.0,0,0,1,1
452892,452892,0.0004311397742572041,0.004601226993865031,0.0,0.0,3,0,3,3
49434,49434,0.0011535476440876205,0.003067484662576687,0.0,0.00047192071731949034,7,1,1,2
36436,36436,0.001514751579002828,0.003067484662576687,0.0,0.0003718163227365682,7,1,1,2
53575,53575,0.0004311397742572041,0.0015337423312883436,0.0,0.0,0,0,1,1
5383,5383,0.0004835055679232508,0.003067484662576687,2.3559790035151207e-06,0.00030674846625766873,1,1,1,2
22512,22512,0.0008422239429485416,0.0015337423312883436,0.0,0.00026673779674579886,1,1,0,1
5493,5493,0.0004311397742572041,0.0015337423312883436,0.0,0.0,3,0,1,1
55965,55965,0.0004311397742572041,0.003067484662576687,0.0,0.0,4,0,2,2
61944,61944,0.0004311397742572041,0.0015337423312883436,0.0,0.0,-1,0,1,1
4720,4720,0.0007977003299195306,0.0015337423312883436,0.0,0.00017041581458759374,-1,1,0,1
5193,5193,0.0015884584070758152,0.007668711656441718,0.0,0.0012640733499629205,3,5,0,5
81265,81265,0.0028675805773927133,0.003067484662576687,0.0,0.0,-1,1,1,2
84219,84219,0.0004311397742572041,0.003067484662576687,0.0,0.0,3,0,2,2
42182,42182,0.0018077767203547876,0.010736196319018405,0.0005984186668928406,0.0035904298160429676,2,6,1,7
64906,64906,0.0005831393104161111,0.003067484662576687,0.0,0.001098800476146873,2,2,0,2
97881,97881,0.0028675805773927133,0.003067484662576687,0.0,0.00019171779141104295,-1,1,1,2
97882,97882,0.0028675805773927133,0.003067484662576687,0.0,0.00017041581458759374,-1,1,1,2
98992,98992,0.0005006285430857373,0.003067484662576687,0.0,0.005553263931302929,0,1,1,2
106789,106789,0.0004311397742572041,0.003067484662576687,0.0,0.0,4,0,2,2
108272,108272,0.0004311397742572041,0.003067484662576687,0.0,0.0,0,0,2,2
113367,113367,0.0028675805773927133,0.003067484662576687,0.0,0.00025562372188139056,-1,1,1,2
49673,49673,0.0028675805773927133,0.003067484662576687,0.0,0.00019171779141104295,-1,1,1,2
116808,116808,0.0004311397742572041,0.003067484662576687,0.0,0.0,4,0,2,2
117539,117539,0.0028675805773927133,0.003067484662576687,0.0,0.00019171779141104295,-1,1,1,2
24443,24443,0.0028675805773927133,0.003067484662576687,0.0,0.00019171779141104295,-1,1,1,2
13809,13809,0.0014668808691434276,0.003067484662576687,0.0,0.0031100578996023547,2,1,1,2
124340,124340,0.0004311397742572041,0.004601226993865031,0.0,0.0,2,0,3,3
128,128,0.0004311397742572041,0.003067484662576687,0.0,0.0,2,0,2,2
130098,130098,0.0004311397742572041,0.003067484662576687,0.0,0.0,3,0,2,2
137746,137746,0.0004311397742572041,0.003067484662576687,0.0,0.0,0,0,2,2
169977,169977,0.0004311397742572041,0.003067484662576687,0.0,0.0,3,0,2,2
170862,170862,0.0004311397742572041,0.004601226993865031,0.0,0.0,11,0,3,3
183241,183241,0.0028675805773927133,0.003067484662576687,0.0,0.0,-1,1,1,2
184761,184761,0.0004311397742572041,0.006134969325153374,0.0,0.0,4,0,4,4
185437,185437,0.0004311397742572041,0.0015337423312883436,0.0,0.0,0,0,1,1
195807,195807,0.0009624808888300049,0.003067484662576687,0.0,0.00025562372188139056,4,1,1,2
278811,278811,0.0012496128531788132,0.004601226993865031,2.3559790035151207e-06,0.00019171779141104295,4,1,2,3
201103,201103,0.0004311397742572041,0.003067484662576687,0.0,0.0,17,0,2,2
231955,231955,0.0004311397742572041,0.003067484662576687,0.0,0.0,-1,0,2,2
7533,7533,0.0006406029489213907,0.003067484662576687,0.0,0.00019171779141104295,-1,1,1,2
24647,24647,0.0004311397742572041,0.003067484662576687,0.0,0.0,3,0,2,2
247265,247265,0.0004311397742572041,0.0015337423312883436,0.0,0.0,0,0,1,1
25006,25006,0.0011535476440876205,0.003067484662576687,0.0,0.0004630165528417641,7,1,1,2
252993,252993,0.0028675805773927133,0.003067484662576687,0.0,0.0,-1,1,1,2
26175,26175,0.0007178824479745806,0.004601226993865031,9.423916014060483e-06,0.000245398773006135,8,1,2,3
26674,26674,0.0028675805773927133,0.003067484662576687,0.0,0.0,-1,1,1,2
26677,26677,0.0005694791517543499,0.006134969325153374,0.0,0.0,2,1,3,4
280798,280798,0.0004311397742572041,0.003067484662576687,0.0,0.0,2,0,2,2
287121,287121,0.0007499813992654868,0.004601226993865031,0.0,0.0,1,1,2,3
322484,322484,0.0004311397742572041,0.003067484662576687,0.0,0.0,3,0,2,2
35723,35723,0.000539170311344615,0.003067484662576687,0.0,0.00043136503067484663,2,2,0,2
36840,36840,0.0006010872738858996,0.003067484662576687,4.711958007030241e-06,0.0005873906800678763,5,1,1,2
37162,37162,0.0004311397742572041,0.0015337423312883436,0.0,0.0,0,0,1,1
389438,389438,0.0028675805773927133,0.003067484662576687,0.0,0.00025562372188139056,-1,1,1,2
290322,290322,0.0028675805773927133,0.003067484662576687,0.0,0.00019171779141104295,-1,1,1,2
3972,3972,0.0006356403342962267,0.006134969325153374,2.8271748042181448e-05,0.0008494572911750827,1,3,1,4
42714,42714,0.0028675805773927133,0.003067484662576687,0.0,0.0,-1,1,1,2
440798,440798,0.0028675805773927133,0.003067484662576687,0.0,0.0,-1,1,1,2
34801,34801,0.0008377442204378359,0.0015337423312883436,0.0,0.0003366751458925632,18,1,0,1
452453,452453,0.0004311397742572041,0.003067484662576687,0.0,0.0,0,0,2,2
453313,453313,0.0004311397742572041,0.003067484662576687,0.0,0.0,3,0,2,2
49701,49701,0.0028675805773927133,0.003067484662576687,0.0,0.00019171779141104295,-1,1,1,2
8959,8959,0.0028675805773927133,0.003067484662576687,0.0,0.00019171779141104295,-1,1,1,2
50267,50267,0.0004311397742572041,0.0015337423312883436,0.0,0.0,6,0,1,1
6072,6072,0.0004311397742572041,0.003067484662576687,0.0,0.0,2,0,2,2
69883,69883,0.0013598456688365139,0.004601226993865031,8.717122313005947e-05,0.00025562372188139056,4,1,2,3
242935,242935,0.0010920314122694818,0.003067484662576687,0.0,0.00019171779141104295,4,1,1,2
69891,69891,0.0004311397742572041,0.0015337423312883436,0.0,0.0,4,0,1,1
80426,80426,0.0005191143076161626,0.003067484662576687,4.711958007030241e-06,0.00025562372188139056,6,1,1,2
153606,153606,0.0005777639965221348,0.0015337423312883436,0.0,0.00019171779141104295,12,1,0,1
96775,96775,0.0004311397742572041,0.003067484662576687,0.0,0.0,1,0,2,2
44307,44307,0.0006266387372771115,0.003067484662576687,0.0,0.00019171779141104295,1,1,1,2
103439,103439,0.0004311397742572041,0.006134969325153374,0.0,0.0,2,0,4,4
108538,108538,0.0004311397742572041,0.003067484662576687,0.0,0.0,0,0,2,2
109647,109647,0.0004311397742572041,0.003067484662576687,0.0,0.0,5,0,2,2
121414,121414,0.0004311397742572041,0.003067484662576687,0.0,0.0,0,0,2,2
129505,129505,0.0004311397742572041,0.0015337423312883436,0.0,0.0,9,0,1,1
12966,12966,0.0008924505038649885,0.006134969325153374,2.3559790035151207e-06,0.00012781186094069528,10,2,2,4
130735,130735,0.0004311397742572041,0.0015337423312883436,0.0,0.0,-1,0,1,1
22470,22470,0.0011642608855818573,0.003067484662576687,0.0,0.00047192071731949034,-1,2,0,2
132404,132404,0.0005329621508300726,0.007668711656441718,9.423916014060483e-06,0.00030674846625766873,12,1,4,5
13374,13374,0.0004311397742572041,0.003067484662576687,0.0,0.0,0,0,2,2
135547,135547,0.0006144200520883674,0.003067484662576687,0.0,0.00030674846625766873,-1,1,1,2
6080,6080,0.0011368132533522324,0.003067484662576687,0.0,0.0005112474437627811,-1,2,0,2
26367,26367,0.0006188452873584091,0.0015337423312883436,0.0,0.00020449897750511248,1,1,0,1
148228,148228,0.0004311397742572041,0.0015337423312883436,0.0,0.0,0,0,1,1
1880,1880,0.0004311397742572041,0.0015337423312883436,0.0,0.0,3,0,1,1
3604,3604,0.001599567950091583,0.006134969325153374,0.0,0.00098159509202454,3,4,0,4
189336,189336,0.0004311397742572041,0.0015337423312883436,0.0,0.0,18,0,1,1
191855,191855,0.0004311397742572041,0.0015337423312883436,0.0,0.0,0,0,1,1
196276,196276,0.0004311397742572041,0.003067484662576687,0.0,0.0,11,0,2,2
209683,209683,0.0004311397742572041,0.003067484662576687,0.0,0.0,-1,0,2,2
214092,214092,0.0004311397742572041,0.003067484662576687,0.0,0.0,3,0,2,2
218783,218783,0.0004311397742572041,0.003067484662576687,0.0,0.0,4,0,2,2
226183,226183,0.0004311397742572041,0.003067484662576687,0.0,0.0,1,0,2,2
230115,230115,0.0004311397742572041,0.006134969325153374,0.0,0.0,20,0,4,4
68308,68308,0.0005337767298426555,0.0015337423312883436,0.0,0.00021910604732690623,20,1,0,1
230245,230245,0.0004311397742572041,0.003067484662576687,0.0,0.0,1,0,2,2
242386,242386,0.0028675805773927133,0.003067484662576687,0.0,0.0,-1,1,1,2
254006,254006,0.0028675805773927133,0.003067484662576687,0.0,0.00030674846625766873,-1,1,1,2
254004,254004,0.0028675805773927133,0.003067484662576687,0.0,0.00021910604732690623,-1,1,1,2
254417,254417,0.0004311397742572041,0.003067484662576687,0.0,0.0,0,0,2,2
258530,258530,0.0028675805773927133,0.003067484662576687,0.0,0.00025562372188139056,-1,1,1,2
84831,84831,0.0028675805773927133,0.003067484662576687,0.0,0.00021910604732690623,-1,1,1,2
13798,13798,0.0004946506245058502,0.004601226993865031,0.0002450218163655726,0.0008030064561719076,5,1,2,3
262889,262889,0.0028675805773927133,0.003067484662576687,0.0,0.0,-1,1,1,2
26334,26334,0.0004311397742572041,0.004601226993865031,0.0,0.0,0,0,3,3
265554,265554,0.0004311397742572041,0.004601226993865031,0.0,0.0,14,0,3,3
267269,267269,0.0004311397742572041,0.004601226993865031,0.0,0.0,1,0,3,3
269219,269219,0.0004311397742572041,0.003067484662576687,0.0,0.0,8,0,2,2
27036,27036,0.0004311397742572041,0.003067484662576687,0.0,0.0,0,0,2,2
35382,35382,0.0006999508484095769,0.003067484662576687,0.0,0.00043821209465381246,0,2,0,2
27399,27399,0.0028675805773927133,0.003067484662576687,0.0,0.0,-1,1,1,2
278509,278509,0.0004311397742572041,0.0015337423312883436,0.0,0.0,-1,0,1,1
6948,6948,0.0007977003299195306,0.0015337423312883436,0.0,0.00021910604732690623,-1,1,0,1
280974,280974,0.0004311397742572041,0.003067484662576687,0.0,0.0,0,0,2,2
288158,288158,0.0004311397742572041,0.004601226993865031,0.0,0.0,2,0,3,3
302964,302964,0.0004311397742572041,0.003067484662576687,0.0,0.0,1,0,2,2
309547,309547,0.0004311397742572041,0.006134969325153374,0.0,0.0,3,0,4,4
1881,1881,0.0005684011007690362,0.0015337423312883436,0.0,0.00021910604732690623,23,1,0,1
3255,3255,0.0007499813992654868,0.004601226993865031,0.0,0.0,2,1,2,3
2177,2177,0.000735210538716273,0.003067484662576687,0.0,0.0031988957790381814,5,2,0,2
350982,350982,0.0004311397742572041,0.007668711656441718,0.0,0.0,10,0,5,5
46754,46754,0.0005166705705784137,0.0015337423312883436,0.0,0.00021910604732690623,10,1,0,1
35375,35375,0.0010993465067264323,0.006134969325153374,0.00031098922846399594,0.0022942931301827008,4,2,2,4
16358,16358,0.001462856047681967,0.004601226993865031,0.0,0.002028295980969075,4,3,0,3
360424,360424,0.0028675805773927133,0.003067484662576687,0.0,0.00030674846625766873,-1,1,1,2
167007,167007,0.0028675805773927133,0.003067484662576687,0.0,0.00021910604732690623,-1,1,1,2
39124,39124,0.0004311397742572041,0.003067484662576687,0.0,0.0,4,0,2,2
396118,396118,0.0028675805773927133,0.003067484662576687,0.0,0.0,-1,1,1,2
40407,40407,0.0028675805773927133,0.003067484662576687,0.0,0.0,-1,1,1,2
42947,42947,0.0004311397742572041,0.0015337423312883436,0.0,0.0,1,0,1,1
47220,47220,0.0004311397742572041,0.0015337423312883436,0.0,0.0,1,0,1,1
48350,48350,0.0011973809061089655,0.004601226993865031,2.3559790035151207e-06,0.00030674846625766873,-1,1,2,3
123084,123084,0.0009794118138533527,0.0015337423312883436,0.0,0.00032289312237649337,-1,1,0,1
50228,50228,0.000601074338435879,0.003067484662576687,0.0,0.00021910604732690623,6,1,1,2
103448,103448,0.0007981293549285967,0.003067484662576687,0.0,0.00021910604732690623,2,1,1,2
511,511,0.0008735476559744703,0.006134969325153374,1.1779895017575603e-05,0.0008494572911750827,7,3,1,4
51181,51181,0.0004311397742572041,0.003067484662576687,0.0,0.0,1,0,2,2
52150,52150,0.0007977003299195306,0.003067484662576687,2.3559790035151207e-06,0.00025562372188139056,-1,1,1,2
90083,90083,0.0011093656211226077,0.0015337423312883436,0.0,0.00030674846625766873,-1,1,0,1
60035,60035,0.0004311397742572041,0.003067484662576687,0.0,0.0,4,0,2,2
208867,208867,0.0018926906826537244,0.003067484662576687,0.0,0.0007575190782582673,3,1,1,2
6958,6958,0.0004311397742572041,0.0015337423312883436,0.0,0.0,21,0,1,1
54070,54070,0.0006832890049703802,0.003067484662576687,0.0,0.0005112474437627811,0,2,0,2
71822,71822,0.0004311397742572041,0.0015337423312883436,0.0,0.0,4,0,1,1
4177,4177,0.0005298291546278305,0.0015337423312883436,0.0,0.00021910604732690623,3,1,0,1
77276,77276,0.0004311397742572041,0.0015337423312883436,0.0,0.0,3,0,1,1
81403,81403,0.0004311397742572041,0.0015337423312883436,0.0,0.0,3,0,1,1
81422,81422,0.0004311397742572041,0.0015337423312883436,0.0,0.0,7,0,1,1
85739,85739,0.0011522868228835343,0.003067484662576687,0.0,0.0009494595384165936,5,1,1,2
8992,8992,0.0028675805773927133,0.003067484662576687,0.0,0.0,-1,1,1,2
207170,207170,0.002101479507112773,0.003067484662576687,0.0,0.00025562372188139056,-1,1,1,2
98762,98762,0.0004311397742572041,0.003067484662576687,0.0,0.0,2,0,2,2
10339,10339,0.0004311397742572041,0.003067484662576687,0.0,0.0,3,0,2,2
113088,113088,0.0004311397742572041,0.0015337423312883436,0.0,0.0,0,0,1,1
115093,115093,0.0004311397742572041,0.004601226993865031,0.0,0.0,8,0,3,3
116323,116323,0.0004944800486222891,0.003067484662576687,1.1779895017575603e-06,0.0003834355828220859,0,1,1,2
125279,125279,0.0004311397742572041,0.003067484662576687,0.0,0.0,-1,0,2,2
468,468,0.0009976424511898905,0.003067484662576687,0.0,0.0005577244841048522,-1,2,0,2
132857,132857,0.0004311397742572041,0.003067484662576687,0.0,0.0,0,0,2,2
13879,13879,0.0004311397742572041,0.003067484662576687,0.0,0.0,3,0,2,2
49825,49825,0.0006310818955275641,0.003067484662576687,0.0,0.00025562372188139056,3,1,1,2
139790,139790,0.0028675805773927133,0.003067484662576687,0.0,0.00025562372188139056,-1,1,1,2
82150,82150,0.0028675805773927133,0.003067484662576687,0.0,0.00025562372188139056,-1,1,1,2
140393,140393,0.0004311397742572041,0.006134969325153374,0.0,0.0,1,0,4,4
236655,236655,0.0005311108348923841,0.0015337423312883436,0.0,0.00025562372188139056,1,1,0,1
14205,14205,0.0004311397742572041,0.0015337423312883436,0.0,0.0,-1,0,1,1
19870,19870,0.0007525693743429928,0.0015337423312883436,0.0,0.00029214139643587495,22,1,0,1
154203,154203,0.0004311397742572041,0.003067484662576687,0.0,0.0,5,0,2,2
156116,156116,0.0028675805773927133,0.003067484662576687,0.0,0.00030674846625766873,-1,1,1,2
309343,309343,0.0028675805773927133,0.003067484662576687,0.0,0.00025562372188139056,-1,1,1,2
23769,23769,0.0005777639965221348,0.0015337423312883436,0.0,0.00025562372188139056,2,1,0,1
16672,16672,0.0005596685553235499,0.003067484662576687,0.0,0.00025562372188139056,4,1,1,2
167,167,0.0004311397742572041,0.003067484662576687,0.0,0.0,3,0,2,2
106925,106925,0.0006400742994002594,0.003067484662576687,0.0,0.0005577244841048522,1,2,0,2
169287,169287,0.0004311397742572041,0.003067484662576687,0.0,0.0,0,0,2,2
2342,2342,0.0006310818955275641,0.0015337423312883436,0.0,0.00025562372188139056,0,1,0,1
16970,16970,0.0004311397742572041,0.0015337423312883436,0.0,0.0,-1,0,1,1
2417,2417,0.0007977003299195306,0.0015337423312883436,0.0,0.00025562372188139056,-1,1,0,1
170665,170665,0.0004311397742572041,0.003067484662576687,0.0,0.0,3,0,2,2
171153,171153,0.0028675805773927133,0.003067484662576687,0.0,0.0,-1,1,1,2
17155,17155,0.0004311397742572041,0.0015337423312883436,0.0,0.0,1,0,1,1
175276,175276,0.0004311397742572041,0.003067484662576687,0.0,0.0,0,0,2,2
175682,175682,0.0028675805773927133,0.003067484662576687,0.0,0.0,-1,1,1,2
176481,176481,0.0004311397742572041,0.004601226993865031,0.0,0.0,1,0,3,3
177272,177272,0.0004311397742572041,0.003067484662576687,0.0,0.0,8,0,2,2
18431,18431,0.0004311397742572041,0.003067484662576687,0.0,0.0,1,0,2,2
187431,187431,0.0004311397742572041,0.003067484662576687,0.0,0.0,0,0,2,2
13765,13765,0.0006144200520883674,0.0015337423312883436,0.0,0.00025562372188139056,0,1,0,1
188618,188618,0.0004311397742572041,0.003067484662576687,0.0,0.0,0,0,2,2
192549,192549,0.0004311397742572041,0.004601226993865031,0.0,0.0,1,0,3,3
201077,201077,0.0004311397742572041,0.003067484662576687,0.0,0.0,1,0,2,2
220156,220156,0.0004311397742572041,0.0015337423312883436,0.0,0.0,-1,0,1,1
220181,220181,0.0004311397742572041,0.003067484662576687,0.0,0.0,5,0,2,2
22240,22240,0.0028675805773927133,0.003067484662576687,0.0,0.00030674846625766873,-1,1,1,2
126458,126458,0.0028675805773927133,0.003067484662576687,0.0,0.00025562372188139056,-1,1,1,2
228260,228260,0.0004311397742572041,0.003067484662576687,0.0,0.0,1,0,2,2
59195,59195,0.0011328921630337147,0.003067484662576687,0.0,0.0005112474437627811,-1,2,0,2
237922,237922,0.0028675805773927133,0.003067484662576687,0.0,0.0,-1,1,1,2
238671,238671,0.0028675805773927133,0.003067484662576687,0.0,0.0,-1,1,1,2
244580,244580,0.0028675805773927133,0.003067484662576687,0.0,0.0,-1,1,1,2
245376,245376,0.0004311397742572041,0.003067484662576687,0.0,0.0,-1,0,2,2
156668,156668,0.0006144200520883674,0.003067484662576687,2.3559790035151207e-06,0.00025562372188139056,-1,1,1,2
38602,38602,0.0006144200520883674,0.0015337423312883436,0.0,0.00025562372188139056,-1,1,0,1
250019,250019,0.0028675805773927133,0.003067484662576687,0.0,0.00030674846625766873,-1,1,1,2
250017,250017,0.0028675805773927133,0.003067484662576687,0.0,0.00025562372188139056,-1,1,1,2
268877,268877,0.0004311397742572041,0.003067484662576687,0.0,0.0,2,0,2,2
273882,273882,0.0004311397742572041,0.003067484662576687,0.0,0.0,1,0,2,2
286381,286381,0.0028675805773927133,0.003067484662576687,0.0,0.00030674846625766873,-1,1,1,2
286380,286380,0.0028675805773927133,0.003067484662576687,0.0,0.00025562372188139056,-1,1,1,2
29081,29081,0.0008040486454771799,0.004601226993865031,0.0,0.0,0,1,2,3
29542,29542,0.0004311397742572041,0.0015337423312883436,0.0,0.0,0,0,1,1
295879,295879,0.0004311397742572041,0.003067484662576687,0.0,0.0,5,0,2,2
35352,35352,0.000512597675515499,0.0015337423312883436,0.0,0.00025562372188139056,4,1,0,1
297587,297587,0.0028675805773927133,0.003067484662576687,0.0,0.0,-1,1,1,2
303217,303217,0.0004311397742572041,0.003067484662576687,0.0,0.0,5,0,2,2
338835,338835,0.0028675805773927133,0.003067484662576687,0.0,0.0,-1,1,1,2
340987,340987,0.0004311397742572041,0.0015337423312883436,0.0,0.0,4,0,1,1
35103,35103,0.0004311397742572041,0.003067484662576687,0.0,0.0,0,0,2,2
364727,364727,0.0028675805773927133,0.003067484662576687,0.0,0.0,-1,1,1,2
387245,387245,0.0004311397742572041,0.0015337423312883436,0.0,0.0,1,0,1,1
398121,398121,0.0028675805773927133,0.003067484662576687,0.0,0.0,-1,1,1,2
42894,42894,0.0004311397742572041,0.0015337423312883436,0.0,0.0,1,0,1,1
429298,429298,0.0004311397742572041,0.0015337423312883436,0.0,0.0,8,0,1,1
435809,435809,0.0004311397742572041,0.0015337423312883436,0.0,0.0,0,0,1,1
43719,43719,0.0004311397742572041,0.003067484662576687,0.0,0.0,3,0,2,2
4561,4561,0.0004311397742572041,0.0015337423312883436,0.0,0.0,-1,0,1,1
4570,4570,0.0007977003299195306,0.0015337423312883436,0.0,0.00025562372188139056,-1,1,0,1
47241,47241,0.0028675805773927133,0.003067484662576687,0.0,0.00030674846625766873,-1,1,1,2
13275,13275,0.0028675805773927133,0.003067484662576687,0.0,0.00025562372188139056,-1,1,1,2
47631,47631,0.004085800978960469,0.004601226993865031,0.0,0.00030674846625766873,6,2,1,3
10741,10741,0.0009010872367681886,0.003067484662576687,0.0,0.00025562372188139056,-1,1,1,2
48652,48652,0.0028675805773927133,0.003067484662576687,0.0,0.0,-1,1,1,2
51886,51886,0.0004311397742572041,0.0015337423312883436,0.0,0.0,0,0,1,1
51892,51892,0.0028675805773927133,0.003067484662576687,0.0,0.0,-1,1,1,2
77579,77579,0.0004311397742572041,0.003067484662576687,0.0,0.0,4,0,2,2
80428,80428,0.0028675805773927133,0.003067484662576687,0.0,0.0,-1,1,1,2
81723,81723,0.0004311397742572041,0.0015337423312883436,0.0,0.0,7,0,1,1
88951,88951,0.0004311397742572041,0.003067484662576687,0.0,0.0,4,0,2,2
91119,91119,0.0028675805773927133,0.003067484662576687,0.0,0.00030674846625766873,-1,1,1,2
190207,190207,0.0028675805773927133,0.003067484662576687,0.0,0.00025562372188139056,-1,1,1,2
91359,91359,0.0028675805773927133,0.003067484662576687,0.0,0.00030674846625766873,-1,1,1,2
16640,16640,0.0028675805773927133,0.003067484662576687,0.0,0.00025562372188139056,-1,1,1,2
121293,121293,0.0007345990127641072,0.0015337423312883436,0.0,0.0002079650618696059,13,1,0,1
126503,126503,0.0007716459866589888,0.003067484662576687,0.0,0.0004811740647179117,12,1,1,2
97129,97129,0.0004311397742572041,0.0015337423312883436,0.0,0.0,2,0,1,1
973,973,0.0028675805773927133,0.003067484662576687,0.0,0.0,-1,1,1,2
10269,10269,0.0004311397742572041,0.0015337423312883436,0.0,0.0,9,0,1,1
103759,103759,0.0004311397742572041,0.003067484662576687,0.0,0.0,1,0,2,2
14075,14075,0.0005838733391165068,0.0015337423312883436,0.0,0.00030674846625766873,0,1,0,1
110170,110170,0.0004311397742572041,0.003067484662576687,0.0,0.0,5,0,2,2
111056,111056,0.0004311397742572041,0.0015337423312883436,0.0,0.0,-1,0,1,1
21198,21198,0.0007977003299195306,0.0015337423312883436,0.0,0.00030674846625766873,-1,1,0,1
13603,13603,0.0005456899479016812,0.0015337423312883436,0.0,0.00030674846625766873,8,1,0,1
16527,16527,0.000572124603358099,0.0015337423312883436,0.0,0.00030674846625766873,4,1,0,1
48357,48357,0.000848126107293582,0.0015337423312883436,0.0,0.0008491906693008909,5,1,0,1
117615,117615,0.0006376125089190498,0.003067484662576687,2.3559790035151207e-06,0.00030674846625766873,1,1,1,2
11998,11998,0.0028675805773927133,0.003067484662576687,0.0,0.0,-1,1,1,2
12038,12038,0.0004311397742572041,0.003067484662576687,0.0,0.0,1,0,2,2
317,317,0.0005977582086491707,0.0015337423312883436,0.0,0.00030674846625766873,-1,1,0,1
126028,126028,0.0004311397742572041,0.0015337423312883436,0.0,0.0,6,0,1,1
12965,12965,0.0004990213586391164,0.0015337423312883436,0.0,0.00030674846625766873,1,1,0,1
130815,130815,0.001404259887661119,0.004601226993865031,0.0,0.0006134969325153375,1,2,1,3
132830,132830,0.0004311397742572041,0.0015337423312883436,0.0,0.0,-1,0,1,1
133572,133572,0.0028675805773927133,0.003067484662576687,0.0,0.00030674846625766873,-1,1,1,2
145703,145703,0.0028675805773927133,0.003067484662576687,0.0,0.00030674846625766873,-1,1,1,2
134319,134319,0.0004311397742572041,0.003067484662576687,0.0,0.0,6,0,2,2
136575,136575,0.0004311397742572041,0.0015337423312883436,0.0,0.0,0,0,1,1
13820,13820,0.0028675805773927133,0.003067484662576687,0.0,0.0,-1,1,1,2
150341,150341,0.0028675805773927133,0.003067484662576687,0.0,0.0,-1,1,1,2
15421,15421,0.0004311397742572041,0.0015337423312883436,0.0,0.0,3,0,1,1
15493,15493,0.0028675805773927133,0.003067484662576687,0.0,0.00030674846625766873,-1,1,1,2
15527,15527,0.0028675805773927133,0.003067484662576687,0.0,0.00030674846625766873,-1,1,1,2
22814,22814,0.0009535329755210691,0.0015337423312883436,0.0,0.0003834355828220859,-1,1,0,1
16460,16460,0.0028675805773927133,0.003067484662576687,0.0,0.0,-1,1,1,2
170101,170101,0.0004311397742572041,0.003067484662576687,0.0,0.0,-1,0,2,2
173407,173407,0.0004311397742572041,0.0015337423312883436,0.0,0.0,0,0,1,1
177747,177747,0.0004311397742572041,0.003067484662576687,0.0,0.0,3,0,2,2
180056,180056,0.0004311397742572041,0.004601226993865031,0.0,0.0,2,0,3,3
19182,19182,0.0028675805773927133,0.003067484662576687,0.0,0.0,-1,1,1,2
204728,204728,0.0004311397742572041,0.003067484662576687,0.0,0.0,1,0,2,2
208279,208279,0.0028675805773927133,0.003067484662576687,0.0,0.0,-1,1,1,2
220962,220962,0.0004311397742572041,0.0015337423312883436,0.0,0.0,3,0,1,1
245594,245594,0.0004311397742572041,0.003067484662576687,0.0,0.0,0,0,2,2
24797,24797,0.0004311397742572041,0.0015337423312883436,0.0,0.0,0,0,1,1
248412,248412,0.0004311397742572041,0.004601226993865031,0.0,0.0,4,0,3,3
254342,254342,0.0028675805773927133,0.003067484662576687,0.0,0.0,-1,1,1,2
255249,255249,0.0004311397742572041,0.003067484662576687,0.0,0.0,0,0,2,2
25640,25640,0.0004311397742572041,0.0015337423312883436,0.0,0.0,0,0,1,1
260659,260659,0.0004311397742572041,0.0015337423312883436,0.0,0.0,-1,0,1,1
13633,13633,0.0007977003299195306,0.0015337423312883436,0.0,0.00030674846625766873,-1,1,0,1
265704,265704,0.0028675805773927133,0.003067484662576687,0.0,0.0,-1,1,1,2
26633,26633,0.0004311397742572041,0.0015337423312883436,0.0,0.0,8,0,1,1
4368,4368,0.00046638598153242786,0.0015337423312883436,0.0,0.00030674846625766873,1,1,0,1
275226,275226,0.0004311397742572041,0.003067484662576687,0.0,0.0,-1,0,2,2
28962,28962,0.0004311397742572041,0.0015337423312883436,0.0,0.0,1,0,1,1
292783,292783,0.0028675805773927133,0.003067484662576687,0.0,0.00030674846625766873,-1,1,1,2
324281,324281,0.0028675805773927133,0.003067484662576687,0.0,0.00030674846625766873,-1,1,1,2
30225,30225,0.0004311397742572041,0.0015337423312883436,0.0,0.0,0,0,1,1
3166,3166,0.0028675805773927133,0.003067484662576687,0.0,0.0,-1,1,1,2
327655,327655,0.0028675805773927133,0.003067484662576687,0.0,0.0,-1,1,1,2
335263,335263,0.0004311397742572041,0.003067484662576687,0.0,0.0,2,0,2,2
350374,350374,0.0004311397742572041,0.0015337423312883436,0.0,0.0,0,0,1,1
